████████████████████████████████████████████████████
█      █         ████████ █  ██   ██     █   █  ████
█ ████ ███ ██ █  █      █ ██    █  █   ████ ███   ██
█ █  █     ████ ██████  █  ███████ ███ █  █ █ █ █ ██
█ █  █  █  █  █   █  ██   ██ █     ██         █ █ ██
█   ███ ██    ██  █   ██       ███     █████    █ ██
██ ██ █  ██ █  ██████  █ █████   █ █   █  █████ ████
██ █  ██  █ █    █     ███   ██  █ ██     █ █     ██
██ ██ S██ █████  █ ██  █   █  ██ █  ██   ██ ██     █
██    ██  █   ██   █  ████ ██  █ ██  █████   █ ███ █
██ ████   █ █  █  ███ █  █     █     █ █   █ ███   █
█        ██ ████  █ █ █ ███  ██████    █  ██ █ █ ███
█ █  █████  █  █  █ █ █   █ ██    ███  ████  █ █  ██
█ █  █   █     █  █   ██ ██ █     █ █       ██     █
█ █████  ██ ████  ██   █    █ █████ ████   ██   ████
█ █   ██     █ █   ███   ██   █   █  █ █ ██████   ██
█ ██   ██  █   █ █ █ █████  █   █ █  █   █    ██  ██
█    █████ ██  ███ █ █ █    █████ █ ██ ███ ██  █   █
███ ██  ██  ██     █       ██   █   █   ██████ ██  █
██  █    █   █ ██  █   ███ █  ███  ██ █ █       █ ██
██ ██ █ ████ █  ██ █ ███ █ ██     ██  █ █████     ██
██ ██ ███ █  ██  █ █ █   █ ████████ ███ █ █ ███  ███
██  █  █    ██   █ ███ ███ █   ██     █ █ █ █ █   ██
██ ███     ███  ██ █ █     █ █  ████    █     █ ████
██   ████ ██ ████  █ ███ ███ ████    ██████ █   █ ██
███     ███    ███ █   ███ █   █  ████ █  █████   ██
█    █      █   █  █ █  █  ███    █        █  █    █
█ ████████████  █    █    ██ █   ██ █████     █ █ ██
███ █        █████ ██████  █ ██ ██  █ █ █████   ████
██    ██████  ██   █    ██ █     █  █     █ █  ██  █
███ ███ █  ██  █ ███     ███ ███ ██ ██ █  █   ██   █
██  █   █  █ █    ██ ██          █  █  ██ █ ███   ██
█  ██ ███ ██ ██ █  ███ ███   ██ ██ ███  █████ █  ███
██  █   █     █ █████      ███  ██               ███
██  ███   ██  █ █  █  ███████    ██  █  █ ███  █  ██
███     ███████ ██ █ ██  ██ ████  ████  █   █  ██  █
█████  ██    █  █  █ █   █   ██  ██    ███  █  ██  █
██     █   ███     █ ██ ██    █   ██████ █████ █████
██ ██████ ██   █ █ █  █    █ ████  ██ █   █  █  ████
██  █  █   █  ████ ██ ███ ██   █  ██    █        ███
██ ███ ███   ██  █  █   ███   ██ ██    ████ ████  ██
█  █     █████     ████      ██   ███ ██  █   █  ███
█ ███  █   █    █     ████ ███  █ █ █ █     █ █   ██
█   ██ ██ ███ ███ ██   █     ████ █ █ █E █  █████ ██
██   ████ █ █   █  ███ █████ █  █ █   ██ █  █   █ ██
██ █        ███ █   █  █   █ ██   ██   █ █ ███  █ ██
██ ███  █ ███   █████ ██ ███  ██   █  ██████   ██  █
██  ███████       █████    ██  ██  █  █   █   ██   █
██  █       █ ██    █   ████    ███████   ██     █ █
███ █████  ██  ██ █   █      ██         █  ███████ █
██         ██████████████████████████████      ██  █
████████████████████████████████████████████████████