███████████████████████S██████████████████████████
█      █       █            █    █      █        █
█   █  ██  █   █   █       ██   ██  █   █   ████ █
█   █   █  █   ██  ██     ██    █   █   █      █ █
█   ██     ██       ██   ██         █   █      █ █
██████  ██  █    █   ██       █    ██  ██  █   █ █
█    ████   ██ ███           ██    █   █   █   █ █
█  ████      ███           ████   ██       █   █ █
█  █     █    ██   █████████  ██  █       ██  ██ █
█  ██    █     █               █      ██  █   █  █
█   ██   ██    ██              ██  ██  ████   █  █
█    █    ██    ███          ████   █   ██   ██  █
█          ██     ████   █████               █   █
████        ██                       █           █
██     ██    █  ██              ██████   █       █
█     ██       ██  ██████████████ ██  █  ██      █
█   ███              █      █      █  ██  ████████
█  ██     ███        █      █      █   █      █  █
████   ██   █  ██    █      █      █   █      █  █
██     ██   ████     █      █      ██  ██     █  █
█    █                  ██  █   █   █   █   ███  █
█   ██                   █  █   █       █████    █
█  ██     █         ██   █      █                █
█ ██    ███    ███   █   █      █████         ██ █
███    ██    ███ ██      █     ██   ████████   █ █
██    ██    ██    ██  ██████   █      ██   █     █
█    ██      ██    ████    █   █     ██          █
█    ██       ██           █   ██    ██  ████   ██
██    ██       ██          █    ███   ██    ██   █
████   ██  █    ██    ██████      ██   ███   ██  █
██      ████    ██         █       ██         █  █
█        ██    ██   █      ████     █        ██  █
█   ███ ██    ██    ██     █  ███  ██       ██   █
█  ██ ███      ██    █     █    ████     ████   ██
████   ███      █  █████   █      ██      ██   ███
███      ██     ████   █   █               ██  ███
█              ███     █   █   ███    █     █   ██
█            ███       █   █     ██   ██    █   ██
█   ██      ██    ██   █   █      █    ██       ██
█  ██████  ██   ███               ██    █     ████
█  █    ████   ██               ███     █     ████
█ ██      █    █    █████████   █      ██     ████
█ █      ██   ██   ██      █         ███   ██   ██
█ █   █  █   ██    █       █       ███      ██   █
█ █   █  █   █         ██  █     ███         █   █
█ █   █  █   █   █    ██   ███████      █    █   █
█ █   █  █████   █   ██        █        ██   █   █
█ █   █          █   █████     █    █  ████  ██  █
█ █   █         ██       █          ███████   █  █
██████████████████████████E███████████████████████