█S█████████████████████████████████████████████████
█     █       █         █     █   █           █   █
█ █████ █ ███ ███ █ ███ ███ █ █ █ █████ █████ █ ███
█       █ █ █   █ █ █   █   █ █ █       █   █ █   █
█ ████ ██ █ ███ ███ █ ███ ███ █ █████████ ███ ███ █
█ █     █ █   █     █     █ █ █ █   █       █   █ █
█ ███ █ █ ███ █████████████ █ █ █ █ █ █████ ███ █ █
█     █ █ █   █               █ █ █ █ █       █   █
███ █████ █ █ █ ███████████████ ███ █ █ █████ ███ █
█ █ █     █ █ █   █ █       █   █   █ █ █   █ █ █ █
█ █ █ █████ █ ███ █ █ █ ███ █ ███ ███ █ ███ █ █ █ █
█ █ █ █     █   █ █   █ █   █   █     █   █     █ █
█ █ █ ███ █ █████ █ ███ █ █████ ███ █████ █████ █ █
█   █   █ █       █   █ █     █   █ █   █ █   █ █ █
███████ █ █████████████ █████ ███ █ █ █ █ █ █ ███ █
█       █               █         █   █ █   █   █ █
█ █████ ███████ ███████████████████████ ███████ █ █
█ █ █   █     █ █             █   █     █     █   █
█ █ █ ███ ███ █ █ ███████████ ███ █ █████ █ █ █████
█ █ █ █     █ █ █     █   █   █   █   █   █ █     █
█ █ █ █ █████ █ █████ █ ███ ███ █ ███ █████ █████ █
█ █   █ █ █   █     █ █     █ █ █   █       █ █   █
█ ███ █ █ █ █████████ █████ ███ ███ █████████ █ ███
█   █ █   █ █     █   █   █   █   █ █ █       █ █ █
█ █ █████ █ █ ███ █ █████ ███ ███ █ █ █ ███ ███ █ █
█ █   █   █   █   █     █ █   █   █ █ █   █   █ █ █
█ ███ █ ███████ █ █████ █ █ ███ ███ █ █ █████ █ █ █
█   █   █ █   █ █     █ █ █ █     █   █ █     █   █
███ █████ █ █ █ █████ █ █ █ █████ █████ █ ███████ █
█ █ █     █ █   █   █ █ █ █ █   █     █ █ █     █ █
█ █ █ ███ █ ███ █ █ ███ █ █ █ █ █ ███ █ █ █ ███ █ █
█ █ █ █   █ █   █ █   █   █   █ █   █ █ █ █   █   █
█ █ ███ █ █ █████ ███ █████████ ███ █ █ █ ███ █████
█       █ █         █           █   █   █         █
█████████████████████████████████████████████████E█