██████████████████████████████████████████████████
█            ██ █ ██ █ ██ █ █ █ █ █ █ █ █ █ █    █
████ ███████ █         █E                   █ ██ █
██        █████████ ██ ████████ ███████ ███ █  █ █
██ █ █ ██ █     █ ███       █ █ ██        █ ██ █ █
██ █ █ ██ █ ███ █     ███ ███ █  █ ██████ █  █ █ █
█  █ █  █ █ █ █ █ █████ ███   ██ █  █   █ ██ █ █ █
█ ██ █ ██ █ █ █ █ █       █ ███  ██ █ ███ ██ █ █ █
█ ██ █ ██ █   █ █ █ █████ █ █ █ ██    ██   █ █ █ █
█  █ █  █ █████ █ █ █   █ █ █ █ ████████ ███ █ █ █
█ ██ ████       █ █ █ █ █ █ █ █          ██  █ █ █
█  █ █    ███████ █ █ █ █ █ █ █████████████ ██ █ █
█ ██ █ ██           █ █ █ █ █ █    █        █  █ █
█    █ █████ █ █ ████ █ █ █   █ ████ ████████ ██ █
█ ██ █   █ ███ ███ ████ █ ██ ██ ██             █ █
█  █ ███ █              █ ██ █   █ ██ ██ ███████ █
█ ██ █   █ ██████████████ █  █ █ ███████       █ █
█ █  ███ █ ███            █ ██ █       █ ███████ █
█ ██ █   █ █   ███ ████████  █ █ █ █ █ █       █ █
█  █ █ ███ █ █ █ █ █     ██ ██ █████ █ ███████ █ █
█ ██ █   █ █ █ █   █ █ █ ██        █ █ █       █ █
█    █ █ █ █ █ ██ ██ ███ ███ █████ █ █ █ ███████ █
█ ██ ███ █   █ ███████    ██ ██ █  █ █ █         █
█ █      █████         ██       ██ █ █ █████████ █
█ ████████ █ ██████████████████  █ █ █         █ █
█ ██                          ██ █ █ █████████ █ █
█ █  ███████████████████████ ██  █ █         █ █ █
█ ██ █                     █ ███ █   █ █████ █ █ █
█ ██ █ ███████████████████ █  ██ ██ ██     █ █ █ █
█  █ █ █                █  ██ █  ███████████ █ █ █
█ ██ █ ███████ ████████ ██ ██ ██       █     █   █
█ ██ █ █              █ █  █  ████████ ██ ████ ███
█  █ █ █ ████████████ █ ██ ██ █      █  █  ██  █ █
██ █ █ █ █          █ █  █ █  ███ ██ ████   █ ██ █
█  █ █ █ ████████ █ █ ██ █ ████ ████    █ █ █    █
██ █ █ █ █      █ █ █ ██ █         ██ █ █ █ █ ██ █
█  █ █ █ ██ █████ █ █ ██ ███ █████ █  █ █ █ █ █  █
██ █ █ █ ██       █ █    ██      █ ██ █ █ █ █ ██ █
█  █ █ █  █████████ █ ██ ███████ █  █ █ █ █ █ ██ █
██ █ █ ██        █  █ ██         █ ██ █ █ █ █ █  █
█    █ ██████ ██ ██ █ ████████████ █  █ █   █ ██ █
██ █ █ █ █ ██ ██    █              ██ █ █ █ █ █  █
██ ███ █    █  █ ██ █████████████████ █ █ █ █ █ ██
█      █ █ ██ ██ ██          █  █     █ ███ █ █ ██
████ █ █ █ █   █ █  ███ █ █ ██ ██ ███ █   ███ █  █
█    █ █ █ ██ ██ ████ █████  █ ██   █ █ █     █ ██
██ ███ █ █  █ █         S█  ██    ███ █████████ ██
█  █ ███ █ ██ █████ ███████  █ ██   █     █      █
██       █      █           ██  █ █ █ █ █ █ █ ██ █
██████████████████████████████████████████████████