      █         ████████ █  ██   ██     █   █  ███
 ████ ███ ██ █  █      █ ██    █  █   ████ ███   █
 █  █     ████ ██████  █  ███████ ███ █  █ █ █ █ █
 █  █  █  █  █   █  ██   ██ █     ██         █ █ █
   ███ ██    ██  █   ██       ███     █████    █ █
█ ██ █  ██ █  ██████  █ █████   █ █   █  █████ ███
█ █  ██  █ █    █     ███   ██  █ ██     █ █     █
█ ██ S██ █████  █ ██  █   █  ██ █  ██   ██ ██     
█    ██  █   ██   █  ████ ██  █ ██  █████   █ ███ 
█ ████   █ █  █  ███ █  █     █     █ █   █ ███   
        ██ ████  █ █ █ ███  ██████    █  ██ █ █ ██
 █  █████  █  █  █ █ █   █ ██    ███  ████  █ █  █
 █  █   █     █  █   ██ ██ █     █ █       ██     
 █████  ██ ████  ██   █    █ █████ ████   ██   ███
 █   ██     █ █   ███   ██   █   █  █ █ ██████   █
 ██   ██  █   █ █ █ █████  █   █ █  █   █    ██  █
    █████ ██  ███ █ █ █    █████ █ ██ ███ ██  █   
██ ██  ██  ██     █       ██   █   █   ██████ ██  
█  █    █   █ ██  █   ███ █  ███  ██ █ █       █ █
█ ██ █ ████ █  ██ █ ███ █ ██     ██  █ █████     █
█ ██ ███ █  ██  █ █ █   █ ████████ ███ █ █ ███  ██
█  █  █    ██   █ ███ ███ █   ██     █ █ █ █ █   █
█ ███     ███  ██ █ █     █ █  ████    █     █ ███
█   ████ ██ ████  █ ███ ███ ████    ██████ █   █ █
██     ███    ███ █   ███ █   █  ████ █  █████   █
    █      █   █  █ █  █  ███    █        █  █    
 ████████████  █    █    ██ █   ██ █████     █ █ █
██ █        █████ ██████  █ ██ ██  █ █ █████   ███
█    ██████  ██   █    ██ █     █  █     █ █  ██  
██ ███ █  ██  █ ███     ███ ███ ██ ██ █  █   ██   
█  █   █  █ █    ██ ██          █  █  ██ █ ███   █
  ██ ███ ██ ██ █  ███ ███   ██ ██ ███  █████ █  ██
█  █   █     █ █████      ███  ██               ██
█  ███   ██  █ █  █  ███████    ██  █  █ ███  █  █
██     ███████ ██ █ ██  ██ ████  ████  █   █  ██  
████  ██    █  █  █ █   █   ██  ██    ███  █  ██  
█     █   ███     █ ██ ██    █   ██████ █████ ████
█ ██████ ██   █ █ █  █    █ ████  ██ █   █  █  ███
█  █  █   █  ████ ██ ███ ██   █  ██    █        ██
█ ███ ███   ██  █  █   ███   ██ ██    ████ ████  █
  █     █████     ████      ██   ███ ██  █   █  ██
 ███  █   █    █     ████ ███  █ █ █ █     █ █   █
   ██ ██ ███ ███ ██   █     ████ █ █ █E █  █████ █
█   ████ █ █   █  ███ █████ █  █ █   ██ █  █   █ █
█ █        ███ █   █  █   █ ██   ██   █ █ ███  █ █
█ ███  █ ███   █████ ██ ███  ██   █  ██████   ██  
█  ███████       █████    ██  ██  █  █   █   ██   
█  █       █ ██    █   ████    ███████   ██     █ 
██ █████  ██  ██ █   █      ██         █  ███████ 
█         ██████████████████████████████      ██  