███████████████████████████████████████████████████
█ █ █ █ █ █ █ █ █   █ █ █ █ █ █ █ █ █ █ █ █ █ █   █
█ █ █ █ █ █   █ █ █ █ █ █ █ █ █ █ █ █ █ █   █ █ █ █
█ █ █ █ █ █ █ █ █ █ █   █ █ █   █ █ █ █ █ █ █ █ █ █
█ █ █   █ █ █ █ █ █ █ █ █ █ █ █ █ █ █ █   █ █ █ █ █
█ █ █ █ █ █ █ █ █ █ █ █ █ █ █ █ █ █   █ █ █ █ █ █ █
█ █   █ █   █ █ █ █ █ █ █ █   █ █ █ █ █ █ █   █ █ █
█ █ █ █ █ █ █ █ █ █ █ █ █ █ █ █ █   █ █ █ █ █ █ █ █
█ █ █ █ █ █ █ █ █ █ █ █ █ █ █ █ █ █ █ █ █ █ █ █ █ █
█ █ █ █ █ █ █ █   █ █ █ █ █ █ █ █ █ █   █ █ █ █ █ █
█ █ █ █ █ █ █ █ █ █ █ █ █   █ █   █ █ █ █ █ █ █ █ █
█   █   █ █ █ █ █ █   █ █ █ █ █ █ █ █ █ █ █ █ █ █ █
█ █ █ █ █ █ █ █ █ █ █ █ █ █ █ █ █ █ █ █ █ █ █ █ █ █
█ █ █ █ █ █ █ █ █ █ █ █ █ █ █ █ █ █   █ █ █ █ █ █ █
█ █ █ █ █   █ █ █   █ █   █ █ █ █ █ █ █ █ █ █ █ █ █
█ █ █ █ █ █ █   █ █ █ █ █ █ █ █ █ █ █ █ █ █ █ █ █ █
█ █ █ █ █ █ █ █ █ █ █ █ █ █ █   █ █ █ █ █   █ █ █ █
█ █ █ █ █ █ █ █ █ █ █ █ █ █ █ █ █ █ █ █ █ █ █ █ █ █
█   █ █ █ █ █ █ █ █ █ █ █ █ █ █ █   █ █ █ █ █   █ █
█ █ █ █ █ █ █ █ █ █ █ █ █ █ █ █ █ █ █ █ █ █ █ █ █ █
█ █ █ █ █ █ █ █ █ █ █ █ █ █ █ █ █ █ █ █ █ █ █ █ █ █
█ █ █ █ █ █   █ █ █ █   █ █ █ █ █ █   █ █ █ █ █ █ █
█ █ █ █   █ █ █ █ █ █ █ █ █ █ █ █ █ █ █   █ █ █ █ █
█ █ █ █ █ █ █ █ █ █ █ █ █ █ █ █   █ █ █ █ █ █ █ █ █
█ █ █ █ █ █ █ █ █ █ █ █ █ █ █ █ █ █ █   █ █ █ █ █ █
█ █ █ █ █ █ █ █ █ █ █ █ █ █ █ █ █ █ █ █ █ █ █ █ █ █
█ █ █ █ █ █ █ █ █ █ █ █ █ █ █ █ █ █ █ █ █ █ █ █ █ █
█ █ █ █ █ █ █ █   █ █ █ █   █ █ █ █ █ █ █ █ █ █ █ █
█ █ █ █ █ █ █ █ █ █ █ █ █ █ █ █ █ █ █ █ █   █ █ █ █
█ █ █ █ █ █ █ █ █ █ █ █ █ █ █ █ █ █ █ █ █ █   █ █ █
█ █ █ █ █ █   █ █ █ █   █ █ █ █ █ █ █ █ █ █ █ █ █ █
█ █   █ █ █ █ █ █   █ █ █ █ █ █ █     █ █ █ █ █ █ █
█ █ █ █ █ █ █   █ █ █ █ █ █ █ █ █ █ █     █ █ █ █ █
█ █ █ █ █ █ █ █ █ █ █ █ █ █ █ █ █ █ █ █ █ █ █ █ █ █
█ █ █ █ █ █ █ █ █ █ █ █ █ █ █ █   █ █ █ █ █ █ █ █ █
█ █ █ █ █ █ █ █ █ █ █ █ █ █ █ █ █ █ █ █ █ █ █ █ █ █
█ █ █ █ █ █ █ █ █ █ █ █ █ █ █ █ █ █ █ █ █ █ █ █ █ █
█   █ █ █ █ █ █ █ █ █ █ █ █ █   █ █ █ █ █ █ █   █ █
█ █ █ █ █   █ █ █ █ █ █ █ █ █ █ █ █ █ █ █ █ █ █ █ █
█ █ █ █ █ █ █ █ █   █ █   █ █ █ █ █   █ █ █ █ █ █ █
█ █ █ █ █ █ █ █ █ █ █ █ █ █ █ █ █ █ █ █ █   █ █ █ █
█ █ █ █ █ █ █ █ █ █ █ █ █ █ █ █ █ █ █ █ █ █ █ █ █ █
█ █ █ █ █ █ █ █ █ █   █ █ █ █ █ █ █ █ █ █ █ █ █ █ █
█ █ █ █   █ █ █ █ █ █ █ █   █ █   █ █ █ █ █ █ █ █ █
█ █ █ █ █ █ █ █ █ █ █ █ █ █ █ █ █ █ █ █ █ █   █ █ █
█ █ █ █ █ █ █ █ █ █ █ █ █ █ █ █ █   █ █ █ █ █ █ █ █
█ █ █ █ █ █ █ █ █ █ █ █ █ █ █   █ █ █ █ █ █ █ █ █ █
S █ █ █ █ █ █ █ █ █ █ █ █ █ █ █ █ █ █ █ █ █ █ █ █ E
█   █   █ █ █ █ █ █ █   █ █ █ █ █ █ █ █ █ █ █ █ █ █
███████████████████████████████████████████████████