█S███████████████████████ █████████████████████████
█           █   █         █             █     █   █
█ ███████████ █ █ ███ ███ █ █████████ █ █ ███ ███ █
█ █       █   █   █ █ █   █ █         █   █ █     █
█ █ █████ █ ███████ █ █ █████ █████████████ █████ █
█ █   █ █           █ █     █ █   █           █ █ █
█ ███ █ █████████████ █████ █ █ ███ ███████ █ █ █ █
█       █             █   █   █     █   █   █   █ █
█████████ ███████████████ █████ █████ █ █ ███████ █
█       █     █     █   █         █   █ █     █   █
█ █████ █████ █ ███ █ █ ███ ███████ ███ █████ █ ███
█ █   █       █   █ █ █   █ █         █ █     █ █ █
█ █ █ ███████████ █ █ ███ ███ █████████ █ █ ███ █ █
█   █             █     █ █   █       █ █ █ █   █ █
█ ███████████████████████ █ ███ █████ █ █ ███ ███ █
█   █           █   █     █ █ █   █ █   █   █   █ █
███ █ █████ ███ █ █ █ █ ███ █ ███ █ ███████ ███ █ █
█ █ █   █   █ █ █ █ █ █ █   █   █ █   █       █ █ █
█ █ █████ ███ █ █ █ █ ███ ███ ███ █ ███ █ █████ █ █
█ █     █ █       █ █     █   █   █   █ █ █   █   █
█ █████ █ ███ ███████ █████ █ █ █████ █ █ █ █ ███ █
█ █     █   █   █   █       █ █ █   █   █   █   █ █
█ █ ███████ ███ █ █ ███ ███████ █ █ █ ███████ ███ █
█ █         █ █ █ █ █   █       █ █ █ █     █   █ █
█ ███████████ █ █ █ █████ █ █████ █ ███ ███ ███ █ █
█     █         █ █     █ █ █   █ █     █   █   █ █
█ █ ███ █████████ █████ █ ███ █ █ ███████ ███ ███ █
█ █ █       █     █ █   █ █   █ █   █       █ █   █
█ █ █ ███████ █████ █ ███ █ █████ █ █ █████ █ █ ███
█ █ █ █ █   █   █         █ █     █ █ █   █ █ █ █ █
█ █ █ █ █ █ ███ █ █████████ █ █████ ███ █ █ █ █ █ █
█ █ █ █ █ █     █   █   █   █     █     █ █ █ █ █ █
█ █ █ █ █ █████████ █ █ █ ███████ ███████ █ █ █ █ █
█ █ █ █ █ █     █ █ █ █   █     █ █     █ █   █   █
███ █ █ █ █ ███ █ █ █ █████ ███ █ █ ███ █ ███ ███ █
█   █ █ █ █ █ █ █   █   █ █   █ █   █   █ █   █   █
█ ███ █ █ █ █ █ ███████ █ █ █ ███████ ███ █ ███ ███
█ █     █     █   █     █ █ █   █   █ █ █ █   █   █
█ █ █████████ ███ █ █████ █ ███ █ █ █ █ █ ███████ █
█ █   █   █     █ █   █   █   █ █ █ █ █ █ █     █ █
█ ███ █ █ █ █████ ███ ███ ███ █ █ █ █ █ █ █ █ ███ █
█   █ █ █ █   █     █   █     █ █ █ █ █ █   █     █
█ █ █ █ █ ███ █ ███ ███ ███ ███ █ █ █ █ ███████████
█ █ █ █ █ █   █ █ █   █   █   █   █   █           █
█ █ █ █ █ █████ █ ███ ███ ███████ █████ ███████ █ █
█ █   █ █       █       █ █     █   █   █     █ █ █
█ █████ ███████████████ █ █ ███ ███ █████ ███ ███ █
█ █ █   █   █   █     █ █   █ █ █   █   █ █ █     █
█ █ █ ███ █ █ █ █ ███ ███████ █ █ ███ █ █ █ █████ █
█   █     █   █     █           █     █   █       █
█████████████████████████ ███████████████████████E█