█████████████████████████████████████████████████████████████████████████████████████████████████████████████████████████████
█S    █                 █         █     █               █     █ █                   █     █     █       █   █         █     █
█ █ ███ █████ █ █████████ █ █████ █ ███ █ █████████ ███ █ ███ █ █ ███ █████████████ ███ █ ███ ███ █ ███ █ █ █ ███████ █ █████
█ █       █   █ █   █   █ █     █   █ █ █     █   █ █   █ █ █   █ █ █   █         █   █ █   █ █   █ █     █ █ █     █ █     █
█ █████████ █ ███ █ █ █ █ █████ █████ █ ███████ █ █ █ ███ █ ███ █ █ ███ ███████ █████ █ ███ █ █ ███ ███████ █ █ █████ █████ █
█     █     █ █   █ █ █       █   █       █     █ █ █ █   █     █   █ █       █     █   █ █ █     █ █   █     █     █   █   █
█████ █ █ █████ █████████████ ███ ███████ █ █████ █ █ █ █ █ ███████ █ ███████ █████ █████ █ █ █████ █ █ ███████ ███ ███ █ ███
█     █ █ █     █     █ █     █ █   █   █   █   █   █ █ █ █ █   █   █ █     █     █     █   █ █   █ █ █   █     █ █   █ █   █
█ █████ ███ █████ ███ █ █ █ █ █ ███ █ █ █████ █ █████ ███ ███ █ █ ███ █ █████████ █ █████ ███ █ █ █ █ ███ █ █████ ███ █ ███ █
█ █   █ █   █ █   █   █ █ █ █     █ █ █  █    █   █       █   █ █ █   █ █   █ █   █ █   █     █ █ █     █ █       █ █ █     █
█ █ █ █ █ ███ █ ███ ███ █ █ █████ █   ████ ██████ ███████ █ ███ █ █ ███ █   █ █ ███ █ █ ███ █ █ █ ███████ ███████ █ █ █ █ ███
█ ███ █ █ █   █ █   █ █ █ █ █   █ █ █      █                █ █   █ █ █   █   █   █   █   █ █ █ █         █       █ █   █   █
█ █             █ ███ █           █ █ ██ ███ █ █         ████ █████ █ █  ███ ██████ █████ █ ███ █ ██ ██████ ███████ █████ ███
█ █  ████████   █ █   ██████ ██ █████ ██ █ █████ ███████  █ █  █  █ █ ██ ███      █     █   █ ███ ██ █ █  █   █           █ █
█ ██ █████████  █ ███  █     ██     █ ██       █ ████████ █ █  █  █    █      ███████████████ █   ██ █ ██ ███ █████████████ █
█    ██     ██ ██      ██    ██     █ ██       █ ██    ██      █     █ █     ██           █       ██ █          █         █ █
████ ██     ██ █  ████  ███████████ █ ██ ████  █ ██    ██  ███ █ ███ █ █████  █ ██ █████  █  ███████ █  ██████  █ ██ ████   █
█  █ ██     ██ ████████   █████████ █ ████████ █ ██    ██   ██   ██  █ █████  █ █████████ █ ████████ █ ████████ █ ████████  █
█ ██ ██    ███        ██     ██     █████   ██   ██    ██   ██   ██  █    ██ ██  ███   ██ █ ███   ██ █ ███   ██   ███   ██  █
█ █  ████████         ██ █   ██ ███ █ ██    ██   ████████   ███ ███ █████ ██  █  ██    ██ ████    ██ █ ██    ██   ██  █  █  █
█ █  ███████  █   ██████ ███ ██ █   █ ██    ██   ███████  █  ██ ██      █ ██ ███ ██    ██   ██    █████████████   ██ ███   ██
█ █  ██      ██ ████████  █  ██ ███ █ ██ █  ██   ██       █  ██ ██ ██████ ██ █   ██    ██   ██    ██   ████████   ██  █     █
█ █  ██       █ ██    ██ ███ ██ █ ███ ██ ██ ██   ██ █ █ ███  ████    █  █ ██ ███ ██    ██   ██    ██   ██       █ ██  █ █████
█ █  ██ █ █████ ██    ██ █ █ ██       ██ █  ██   ██ █ █ █     ███ ██ █    ██   █ ██  █ ██   ███  ███   ███      █ ██  █ █   █
█ █  ██ █ █ █ █ ████████ █ █ ██████   ██ ██ ██ █ ██ █ ███ █   ███  ███ ███████   ██ ██ ██ █ ████████   ████████ █ ██  █ █ █ █
█ █  ██ █ █ █ █   ██████ █ █  █████   ██  █ ██ █ ██ █     █   ██   █   ███████   ██ █  ██ █  ████████   ██████  █ ██  █   █ █
█ █     ███ █ █          █ ██         █   █    █    ███████   ██ ████               █     █           █   █     █     █ ███ █
█ █   █   █ █ █     ███     ███     ███   ███  █  █ █       ████  █   █ █   █ █     █ █ █ █ █ █     █ █   █   █ █     █ █   █
█ █ █████ █ █ █ █████ █ ███ █ █ ███ █ ███ █ █████ ███████  ████   █ ███ █ ███ █████████ ███ █ █ ███ █████ █ ███ ███████████ █
█ █ █     █   █ █     █ █ █   █ █ █ █ █   █     █   █   █  ██     █ █   █ █   █       █   █ █ █   █ █     █   █ █   █ █     █
█ █ █ █████ ███ █ █████ █ █████ █ █ █ █ ███████ █ █ █ ███     █████ █ ███ ███████████ █ █ █ █ ███ █ █ █████ ███ █ ███ █ █████
█   █   █   █   █     █ █   █   █ █   █       █   █ █ █   █   █ █   █ █   █         █   █ █ █     █ █     █ █   █     █ █   █
███ ███ █ ███ ███ ███ █ ███ █ ███ ███ ███████ █████ █ █ ███ ███ ███ █ █ ███████ ███ █ ███ █ ███████ █ █████ █ ███ ███ █ █ ███
█   █   █     █     █ █     █ █   █         █     █   █ █   █     █   █         █   █ █   █       █   █     █   █ █   █ █   █
█ ███ ███████████ █ █ █████ █ ███ █ █████████████ ███ █ ███ █████ ███████████████ ███ █ █ ███████ ███ █ ███████ ███ █ █ ███ █
█   █     █       █ █ █   █ █   █ █ █             █   █   █       █ █     █       █   █ █     █ █   █ █     █   █   █ █   █ █
███ ███ ███ ███ █████ █ █ █████ █ █ █ ███████████████████ █████ ███ █ █ ███ ███ ███████ █████ █ ███ ███████ █ ███ ███ ███ █ █
█ █ █ █ █ █ █ █ █ █ █ █ █ █ █ █ █ █ █ █   █   █ █ █   █ █ █ █       █ █ █ █ █ █ █ █   █ █   █ █ █ █ █   █ █ █ █   █ █ █ █   █
█     █   █   █     █   █       █   █   █   █   █   █     █   █ █ █   █       █ █   █   █ █   █       █ █   █   █   █   █  E█
█████████████████████████████████████████████████████████████████████████████████████████████████████████████████████████████