█S█████████████████████████████████████████████████
█     █             █           █     █   █   █   █
███ ███ ███ ███████ █████ █ ███ ███ █ █ █ █ █ █ ███
█   █     █ █   █   █   █ █ █       █ █ █   █ █   █
█ ███ █████ ███ █ ███ █ ███ █ ███████ █ █████ █ █ █
█ █   █   █ █   █     █   █ █   █   █   █   █ █ █ █
█ █ ███ █ █ █ ███████████ █ █████ █ █████ ███ ███ █
█   █ █ █ █ █     █     █   █     █   █     █     █
█ ███ █ █ █ █████ █ █ █████ █ ███████ █████ █████ █
█   █ █ █   █   █ █ █     █ █   █   █ █   █     █ █
███ █ █ █████ █ █ █ █████ █ ███ █ █ █ █ █ █ ███ █ █
█     █ █     █ █   █   █ █   █ █ █ █ █ █ █   █   █
█ █████ █ █████ █████ █ █ █ ███ ███ █ █ █ █████████
█   █ █   █   █       █ █   █   █   █   █ █       █
█████ █████ █ ███████ █ █████ ███ ███████ █ █████ █
█   █     █ █       █ █     █ █ █       █       █ █
█ █ █████ █ ███████ █ █████ █ █ █ █ ███ █████████ █
█ █   █   █ █   █   █     █ █ █ █ █ █     █       █
█ █ ███ ███ ███ █ █████████ █ █ █ █ ███████ █████ █
█ █     █   █   █         █   █   █     █   █   █ █
█ ███████ ███ █ █████████ █ ███████████ █ ███ ███ █
█ █       █   █ █         █ █           █   █ █   █
█ █ █████ ███ █ █ █████████ █ █████████ ███ █ █ ███
█ █ █   █ █   █ █ █       █   █       █   █ █     █
█ ███ █ █ █ █████ ███ █████████ █████ ███ █ ███████
█ █   █ █ █ █   █   █   █       █   █ █   █       █
█ █ ███ █ █ █ █ ███ ███ █ █████ █ █ █ █ █████████ █
█   █   █ █   █   █   █   █     █ █   █ █       █ █
█████ ███ █ █████ ███ █ ███ ███ ███████ █ ███████ █
█   █ █   █ █   █     █ █ █ █   █   █     █     █ █
█ █ █ █ ███ █ █████████ █ █ █████ █ █ █████ ███ █ █
█ █ █   █ █ █             █       █   █   █ █ █   █
█ █ █████ █ ███████████████████████████ █ █ █ ███ █
█ █                                     █   █     █
█████████████████████████████████████████████████E█